XXXXXXXXXXXXXXXXXXXX
XP                 X
X                  X
X                  X
X                  X
X                  X
X                  X
X                  X
X                  X
X                  X
X                  X
X                 EX
XXXXXXXXXXXXXXXXXXXX