XXXXXXXXXXXXXXXXXXXX
XP Y            Y  X
X  X            X  X
X  X            X  X
X  X            X  X
X  XXXXX    XXXXX  X
X        YY        X
X        YY        X
X  XXXXX    XXXXX  X
X  X            X  X
X  X            X  X
X  Y            Y EX
XXXXXXXXXXXXXXXXXXXX