XXXXXXXXXXXXXXXXXXXX
X                  X
X                  X
X  XX          XX  X
X   X          X   X
X   X          X   X
X P X  YYYYYY  X E X
X   X          X   X
X   X          X   X
X  XX          XX  X
X                  X
X                  X
XXXXXXXXXXXXXXXXXXXX