XXXXXXXXXXXXXXXXXXXX
X                  X
X                  X
X   XYYYYYX        X
X   X     X    X   X
X   Y     X    Y   X
X P Y     X    Y E X
X   Y     X    Y   X
X   X     X    X   X
X         X        X
X                  X
X                  X
XXXXXXXXXXXXXXXXXXXX