XXXXXXXXXXXXXXXXXXXX
XP                 X
XXXXXXXXXXXXXXXX  XX
X                  X
X   XXXXXXXXXXXXXXXX
X   Y              X
X   Y              X
X   Y              X
XXXXXXXXXXXXXXXX   X
X                  X
XX  XXXXXXXXXXXXXXXX
X                 EX
XXXXXXXXXXXXXXXXXXXX