XXXXXXXXXXXXXXXXXXXX
XP                 X
X                  X
X YYY          YYY X
X Y  YYYY  Y  Y  Y X
X Y  Y   Y Y  Y  Y X
X Y  YYYY  Y  Y  Y X
X Y  Y   Y Y  Y  Y X
X Y  YYYY  YYYY  Y X
X YYY          YYY X
X                  X
X                 EX
XXXXXXXXXXXXXXXXXXXX