XXXXXXXXXXXXXXXXXXXX
X                 PX
X XYXYXYXYXYXYXYXYXX
X                  X
XXYXYXYXYXYXYXYXYX X
X                  X
X XYXYXYXYXYXYXYXYXX
X                  X
XXYXYXYXYXYXYXYXYX X
X                  X
X XYXYXYXYXYXYXYXYXX
X                 EX
XXXXXXXXXXXXXXXXXXXX